Alto=7
Ancho=6
######
##   #
#  $ #
#.$#.#
#  $@#
#  .##
######