Alto=8
Ancho=8
   ##  #
 # $ $ #
  *.#  #
# #.@.##
#$###*##
        
   ## # 
#####   